XXXXXXXXXXXXXXXXXXXXXXXXXXXXXXXXXXXXXXXXXXXXXXXXXXXXXXXXXXXX
X12a4352181214352181214352181214352181214352181214352181214X
X836211044822358364109235622351z1132412XXXXXXXX121435218XXXX
X83621104482235836410923562235111324121XXXXXXXX121435218XXXX
X6354231230133141132412121435218121435218121435218121435218X
XXXXXXXXXXXXXXXXXXXXXXXXXXXXXXXXXXXXXXXXXXXXX94121435218731X
X2358364103635423XXXXXXXX1234116203149241143251132412311234X
X0363542312301331XXXXXXXX4235836410363542312341162031492412X
X32511114b2222234XXXXXXXX218362110448223583641092XXX2235121X
X5333794121435213XXXXXXXX384116203149245122331111XXX2341235X
X562038411620363542312301331463542312301331411232XXX2234112X
X6354231230133146354231230133146354231230133146354231230133X
X836211044822358364109235622351XXXXXXXXXXXXXXXXXXXXXXXXXXXXX
X836211044822358364109235622351XXXXXXXXXXXXXXXXXXXXXXXXXXXXX
XXXXXXXXXXXXXXXXXXXXXXXXXXX1111XXXXXXXXXXXXXXXXXXXXXXXXXXXXX
X62038411XXXXXXXXXXXXXXXXXX8362110448293189462938512365111dX
X73633212XXXXXXXXXXXXXXXXXX62110448223512635423123013314XXXX
X14325123XXXXXXXXXXXXXXXXXX56203841162032513273400212312XXXX
X836211044822358364109235622351621104482235XXXXXX0384116201X
X0448293189XXXXX4629385620384116203841183621104482931894629X
X9412143521XXXXX0448293189462938568362110448116203841123561X
X32511c9673XXXXX87492363827234XXXXXXXXXXXXXXXXX738411e02342X
XXXXXXXXXXXXXXXXXXXXXXXX941214352132511XXXXXXXX489620384112X
X3251119113403257198362110448293189462938502653642936297452X
XXXXXXXXXXXXXXXXXXXXXXXXXXXXXXXXXXXXXXXXXXXXXXXXXXXXXXXXXXXX