XXXXX
Xa33X
X1X3X
X1XeX
X313X
XXXXX